#-[..]-#
|......|
/......|
.......|
...|\./|
\..|m..|
|[]|..d|
#------#
###..###
#......#
#......#
.......#
...##.##
#..##..#
####..##
########
