#------#
|Hnsn..|
/......|
.......:
.......:
\..hTd.|
|......|
#-[..]-#
########
#####..#
#......#
.......#
.......#
#..###.#
#......#
###..###
