#------#
|bed..l|
|......\
|#......
|%......
|....../
|......|
#-[..]-#
########
####..##
#......#
##......
##......
#......#
#......#
###..###
