#-[..]-#
|m.....|
|......\
:.......
:.buud..
|....../
|l.TV..|
#------#
###..###
##.....#
#......#
#.......
#.####..
#......#
##.##..#
########
